00000000000000000000000000000000000000000000000000000000000000000000000000000000
00000000000010000010000000000000000000000000010010000100000100000000000000010000
00000000000010000000000000000010001000000000000010000001000000000000000000010010
0000000000001000000000000110        0000001110000000000000000010110100000001100000000000
00001000000000100010000000000000000001100001000000100001000000000000000000000000
00001000001000000100000000000110000000000000000000000001000000000000000100010000
00000000000001000100000010010110000000000100111000000000000000000000101000000000
00000100000000000100010000000000000000100000000000000010000000110000100001001000
01000010010000001011000000000000000000000000000010000000000000010001101000001000
00001000001000000001000100110001000001001000000010010010000000000000000000000000
01100100000100000000100      010000000000101000000000000000010000000000000000100000000
0000000000000000100001000000000000	0000000000000000000000000001000000000000000000
00010000000000000000100011010000010100000000000000000010000001000000000000000010
00010000100000000001000000000000001100010010000000000001000000000000000010001000
00001000000000000001000000000010000000000000000000010000010000000000000000001000
00000010010000000100000000100000000000000100001000000110010000000010010100000000
00000000010000000000000000000000110000000000000010000000000000100000000100000000
00000000000000000000000000010000101000000001000000000100000100000011000010000000
00000000000000010000000100000000001001000000000000001100000000000000010000010000
00000000110010000000000001000000001000010100010000000000100011000100000000000000
00000000110000001000000000000001000000000000000000000000000000010100001000000000
00000000011100000000000000101000000000000010100000000010100000000010000010000000
00000000000010100000000010000000001010000000000010100000010001000000000000101000
00000000010000000010000000001000000000000001001010000000000000000000000000001010
00000000000011010000000100000000000000000000000000011000001000000001011000000000
00000000001001100000000100000000000000010000000000010000000000100000000010000010
00010010000100100000000000000000100000001000000000010000000000000000000000000000
00000000000001100000001100000000000000000000000110000000000000000000000000000000
00000000000000000100000010010000100000000000000000000100001000010010000000000000
00000100000000000000000000000000000000010000000100000000000000100010000010001000
01000010000000010100000000010000100000000000000000001100000011010000000000000100
00001010000000000000000000000001000001100000000100000000000000000000000000000000
00000000000000000000111001000000001000000000000000000000001100000000000011000100
00010011001000000000000000000000000101000000000000000000100010010000101000000000
00001000001001000100000000000000011000001000000000000000001000000100000000001000
00000000000000101000000000000000000000000000001000100001001000000000001000000000
01000000000011001000000000010000000000000000000000000000010000000000000000000000
00001000000010000000000000000000000000011000100000000000000000010000000001000100
00000000000000000000000000000000100000100000000000000000010010000000000000000000
00000000100100010100000000100001100010000000000000000110000100000000000000000100
00000000010000000000000000000100101000100100101000000000000000011100000000100000
00100000000000000000100000000000000000000010000000000000000000000000000000100000
00000000001010100000000000000001100000000100011100010000000000000000000000000010
00101000000000000010000000000000001000000000000000000000001010000000000000000000
00000000000100001000010000010000000000000000000000001000000001000000000000000000
00001000000000000000000000000000000000001000000001011000010000000000001000000000
00000001000000010000000000100000000010100000000000000000000000000100000000000010
00001000000000100000000000001101000001010000000000001001000110000000000010000000
00000000001000000000000000000000000001000000000010100000001000010100000000010000
00000000000010000000101000000000010010000010000000000000010000000000000000000000
01000000000001000000000000010000000000001010000000100001000010001000000000000100
01000000011000010000100000001000001000000000100000001000010000001000100000010000
00000010110010000000000000000000000100000000000010000000010000100001000000000100
00000001000000000001000000000000000000000000110000001010000000000001000000010000
00000000000000010000100000000000000100001000001010000000000000000010100101000000
00000000100000100000000000000001101010001001000010000000000000100000000000000010
00000000000000000000000010100000000000100000000000000000000000000000100100100000
00000000000001100010001000100000000100000000000000000000000010000000000000000000
00000100100010000110000110000000000011000100000000000000100000000001000000000000
01000000000000000100000100000000010100010000010000000001000000000000001000000100
00000000000010000000000101000000010000000100101000000000000100010010000000000000
00001000010000001000000101000000010100000000000100100000000000100000000000100000
01000000000100000000100000000000000000001000010000000000000100001000000000000110
00000100000000000000000000000000000000000000010010000001000000000000000000000000
00000000000001001000000000001000100000000100000000000000001000000000000101000010
00010000000010000000000000000000000010000000000000010000001000100000010001000000
00000000010001000000100000000000100000001000000000100000000100001010000000010000
00100000000000000100010000100100000001000000001000000001000000000010000000000010
00000000000000001100100100000000000001000000100000000100000001100000010000000010
00000000000000000000000000000010000001010000000000011000000000001000000100000000
00000000000000000000000000001100000000000010000000000001000000000000000110001000
00000001000001000100000000000000001000000000000000000000000000000010000000100000
00000000000100100000001000000001000000000000100101000001000010000000000000001000
00000000000000000000000000000000000011000000100001000000000000000000000000000000
00000000000001001010010000000000000000000000000000000000000000100000000000000000
00100000000000011000000000000000100000001000000000000000000000100100000000000000
00000000101010000000000000000100100000000000000000000000000000010100000100000000
00101000000010000010000000000001000000100000000000001000000000000000001000010000
00000000000010000000010000000000000000000000010001000001000001000000000000001000
00000000000000000000000000000000000000000000000000000000000000000000000000000000
